"Date","VisTm","HmTm","VisRuns","HmRuns","HomeWon","RunDiff"
20200723,"SFN","LAN",1,8,"TRUE",7
20200723,"NYA","WAS",4,1,"FALSE",-3
20200724,"MIL","CHN",0,3,"TRUE",3
20200724,"DET","CIN",1,7,"TRUE",6
20200724,"SFN","LAN",1,9,"TRUE",8
20200724,"ATL","NYN",0,1,"TRUE",1
20200724,"MIA","PHI",5,2,"FALSE",-3
20200724,"ARI","SDN",2,7,"TRUE",5
20200724,"PIT","SLN",4,5,"TRUE",1
20200724,"BAL","BOS",2,13,"TRUE",11
20200724,"MIN","CHA",10,5,"FALSE",-5
20200724,"KCA","CLE",0,2,"TRUE",2
20200724,"SEA","HOU",2,8,"TRUE",6
20200724,"ANA","OAK",3,7,"TRUE",4
20200724,"TOR","TBA",6,4,"FALSE",-2
20200724,"COL","TEX",0,1,"TRUE",1
20200725,"MIL","CHN",8,3,"FALSE",-5
20200725,"DET","CIN",6,4,"FALSE",-2
20200725,"SFN","LAN",5,4,"FALSE",-1
20200725,"ATL","NYN",5,3,"FALSE",-2
20200725,"MIA","PHI",1,7,"TRUE",6
20200725,"ARI","SDN",1,5,"TRUE",4
20200725,"PIT","SLN",1,9,"TRUE",8
20200725,"NYA","WAS",2,9,"TRUE",7
20200725,"BAL","BOS",7,2,"FALSE",-5
20200725,"MIN","CHA",3,10,"TRUE",7
20200725,"KCA","CLE",3,2,"FALSE",-1
20200725,"SEA","HOU",2,7,"TRUE",5
20200725,"ANA","OAK",4,1,"FALSE",-3
20200725,"TOR","TBA",1,4,"TRUE",3
20200725,"COL","TEX",3,2,"FALSE",-1
20200726,"MIL","CHN",1,9,"TRUE",8
20200726,"DET","CIN",3,2,"FALSE",-1
20200726,"SFN","LAN",3,1,"FALSE",-2
20200726,"ATL","NYN",14,1,"FALSE",-13
20200726,"MIA","PHI",11,6,"FALSE",-5
20200726,"ARI","SDN",4,3,"FALSE",-1
20200726,"PIT","SLN",5,1,"FALSE",-4
20200726,"NYA","WAS",3,2,"FALSE",-1
20200726,"BAL","BOS",7,4,"FALSE",-3
20200726,"MIN","CHA",14,2,"FALSE",-12
20200726,"KCA","CLE",2,9,"TRUE",7
20200726,"SEA","HOU",7,6,"FALSE",-1
20200726,"ANA","OAK",4,6,"TRUE",2
20200726,"TOR","TBA",5,6,"TRUE",1
20200726,"COL","TEX",5,2,"FALSE",-3
20200727,"CHN","CIN",8,7,"FALSE",-1
20200727,"MIL","PIT",6,5,"FALSE",-1
20200727,"ARI","SDN",2,6,"TRUE",4
20200727,"TOR","WAS",4,1,"FALSE",-3
20200727,"NYN","BOS",7,4,"FALSE",-3
20200727,"KCA","DET",14,6,"FALSE",-8
20200727,"SEA","HOU",5,8,"TRUE",3
20200727,"ANA","OAK",0,3,"TRUE",3
20200727,"ATL","TBA",5,14,"TRUE",9
20200728,"CHN","CIN",8,5,"FALSE",-3
20200728,"MIL","PIT",6,8,"TRUE",2
20200728,"SDN","SFN",5,3,"FALSE",-2
20200728,"TOR","WAS",5,1,"FALSE",-4
20200728,"SEA","ANA",2,10,"TRUE",8
20200728,"NYN","BOS",8,3,"FALSE",-5
20200728,"CHA","CLE",3,4,"TRUE",1
20200728,"CHA","CLE",3,5,"TRUE",2
20200728,"KCA","DET",3,4,"TRUE",1
20200728,"LAN","HOU",5,2,"FALSE",-3
20200728,"SLN","MIN",3,6,"TRUE",3
20200728,"COL","OAK",8,3,"FALSE",-5
20200728,"ATL","TBA",2,5,"TRUE",3
20200728,"ARI","TEX",4,1,"FALSE",-3
20200729,"TBA","ATL",4,7,"TRUE",3
20200729,"CHN","CIN",7,12,"TRUE",5
20200729,"BOS","NYN",6,5,"FALSE",-1
20200729,"MIL","PIT",3,0,"FALSE",-3
20200729,"SDN","SFN",6,7,"TRUE",1
20200729,"TOR","WAS",0,4,"TRUE",4
20200729,"SEA","ANA",10,7,"FALSE",-3
20200729,"NYA","BAL",9,3,"FALSE",-6
20200729,"CHA","CLE",4,0,"FALSE",-4
20200729,"KCA","DET",4,5,"TRUE",1
20200729,"LAN","HOU",4,2,"FALSE",-2
20200729,"SLN","MIN",0,3,"TRUE",3
20200729,"COL","OAK",5,1,"FALSE",-4
20200729,"ARI","TEX",4,7,"TRUE",3
20200730,"LAN","ARI",6,3,"FALSE",-3
20200730,"TBA","ATL",1,2,"TRUE",1
20200730,"BOS","NYN",4,2,"FALSE",-2
20200730,"SDN","SFN",12,7,"FALSE",-5
20200730,"TOR","WAS",4,6,"TRUE",2
20200730,"SEA","ANA",8,5,"FALSE",-3
20200730,"NYA","BAL",8,6,"FALSE",-2
20200730,"KCA","DET",5,3,"FALSE",-2
20200730,"CLE","MIN",2,0,"FALSE",-2
20200731,"LAN","ARI",3,5,"TRUE",2
20200731,"NYN","ATL",10,11,"TRUE",1
20200731,"PIT","CHN",3,6,"TRUE",3
20200731,"SDN","COL",8,7,"FALSE",-1
20200731,"TEX","SFN",2,9,"TRUE",7
20200731,"HOU","ANA",9,6,"FALSE",-3
20200731,"TBA","BAL",3,6,"TRUE",3
20200731,"CIN","DET",2,7,"TRUE",5
20200731,"CHA","KCA",3,2,"FALSE",-1
20200731,"CLE","MIN",1,4,"TRUE",3
20200731,"BOS","NYA",1,5,"TRUE",4
20200731,"OAK","SEA",3,5,"TRUE",2
20200801,"LAN","ARI",11,2,"FALSE",-9
20200801,"NYN","ATL",1,7,"TRUE",6
20200801,"PIT","CHN",3,4,"TRUE",1
20200801,"SDN","COL",1,6,"TRUE",5
20200801,"TEX","SFN",3,7,"TRUE",4
20200801,"HOU","ANA",4,5,"TRUE",1
20200801,"TBA","BAL",4,5,"TRUE",1
20200801,"CHA","KCA",11,5,"FALSE",-6
20200801,"CLE","MIN",0,3,"TRUE",3
20200801,"BOS","NYA",2,5,"TRUE",3
20200801,"OAK","SEA",3,2,"FALSE",-1
20200802,"LAN","ARI",3,0,"FALSE",-3
20200802,"NYN","ATL",0,4,"TRUE",4
20200802,"PIT","CHN",1,2,"TRUE",1
20200802,"SDN","COL",6,9,"TRUE",3
20200802,"TEX","SFN",9,5,"FALSE",-4
20200802,"HOU","ANA",6,5,"FALSE",-1
20200802,"TBA","BAL",1,5,"TRUE",4
20200802,"CIN","DET",4,3,"FALSE",-1
20200802,"CIN","DET",4,0,"FALSE",-4
20200802,"CHA","KCA",9,2,"FALSE",-7
20200802,"CLE","MIN",1,3,"TRUE",2
20200802,"BOS","NYA",7,9,"TRUE",2
20200802,"OAK","SEA",3,2,"FALSE",-1
20200803,"NYN","ATL",7,2,"FALSE",-5
20200803,"KCA","CHN",0,2,"TRUE",2
20200803,"CLE","CIN",2,3,"TRUE",1
20200803,"SFN","COL",6,7,"TRUE",1
20200803,"CHA","MIL",6,4,"FALSE",-2
20200803,"LAN","SDN",4,5,"TRUE",1
20200803,"PIT","MIN",4,5,"TRUE",1
20200803,"PHI","NYA",3,6,"TRUE",3
20200803,"OAK","SEA",11,1,"FALSE",-10
20200804,"HOU","ARI",8,2,"FALSE",-6
20200804,"TOR","ATL",1,10,"TRUE",9
20200804,"KCA","CHN",4,5,"TRUE",1
20200804,"CLE","CIN",4,2,"FALSE",-2
20200804,"SFN","COL",2,5,"TRUE",3
20200804,"CHA","MIL",3,2,"FALSE",-1
20200804,"LAN","SDN",5,2,"FALSE",-3
20200804,"NYN","WAS",3,5,"TRUE",2
20200804,"MIA","BAL",4,0,"FALSE",-4
20200804,"PIT","MIN",3,7,"TRUE",4
20200804,"TEX","OAK",1,5,"TRUE",4
20200804,"ANA","SEA",5,3,"FALSE",-2
20200804,"BOS","TBA",1,5,"TRUE",4
20200805,"HOU","ARI",7,14,"TRUE",7
20200805,"TOR","ATL",2,1,"FALSE",-1
20200805,"SFN","COL",4,3,"FALSE",-1
20200805,"NYA","PHI",7,11,"TRUE",4
20200805,"NYA","PHI",3,1,"FALSE",-2
20200805,"MIN","PIT",5,2,"FALSE",-3
20200805,"LAN","SDN",7,6,"FALSE",-1
20200805,"NYN","WAS",3,1,"FALSE",-2
20200805,"MIA","BAL",1,0,"FALSE",-1
20200805,"MIA","BAL",2,1,"FALSE",-1
20200805,"MIL","CHA",1,0,"FALSE",-1
20200805,"CIN","CLE",0,2,"TRUE",2
20200805,"CHN","KCA",6,1,"FALSE",-5
20200805,"TEX","OAK",4,6,"TRUE",2
20200805,"ANA","SEA",6,7,"TRUE",1
20200805,"BOS","TBA",5,0,"FALSE",-5
20200806,"HOU","ARI",4,5,"TRUE",1
20200806,"TOR","ATL",3,4,"TRUE",1
20200806,"SFN","COL",4,6,"TRUE",2
20200806,"NYA","PHI",4,5,"TRUE",1
20200806,"MIN","PIT",5,6,"TRUE",1
20200806,"MIA","BAL",8,7,"FALSE",-1
20200806,"MIL","CHA",8,3,"FALSE",-5
20200806,"CIN","CLE",0,13,"TRUE",13
20200806,"CHN","KCA",2,13,"TRUE",11
20200806,"TEX","OAK",4,6,"TRUE",2
20200806,"ANA","SEA",6,1,"FALSE",-5
20200807,"SFN","LAN",2,7,"TRUE",5
20200807,"CIN","MIL",8,3,"FALSE",-5
20200807,"MIA","NYN",4,3,"FALSE",-1
20200807,"DET","PIT",17,13,"FALSE",-4
20200807,"ARI","SDN",0,3,"TRUE",3
20200807,"BAL","WAS",11,0,"FALSE",-11
20200807,"TOR","BOS",3,5,"TRUE",2
20200807,"CLE","CHA",0,2,"TRUE",2
20200807,"MIN","KCA",2,3,"TRUE",1
20200807,"HOU","OAK",2,3,"TRUE",1
20200807,"COL","SEA",8,4,"FALSE",-4
20200807,"NYA","TBA",0,1,"TRUE",1
20200807,"ANA","TEX",3,4,"TRUE",1
20200808,"SFN","LAN",5,4,"FALSE",-1
20200808,"CIN","MIL",4,1,"FALSE",-3
20200808,"MIA","NYN",4,8,"TRUE",4
20200808,"ATL","PHI",0,5,"TRUE",5
20200808,"DET","PIT",11,5,"FALSE",-6
20200808,"ARI","SDN",3,2,"FALSE",-1
20200808,"BAL","WAS",5,3,"FALSE",-2
20200808,"TOR","BOS",2,1,"FALSE",-1
20200808,"CLE","CHA",7,1,"FALSE",-6
20200808,"MIN","KCA",6,9,"TRUE",3
20200808,"HOU","OAK",1,3,"TRUE",2
20200808,"COL","SEA",5,0,"FALSE",-5
20200808,"NYA","TBA",8,4,"FALSE",-4
20200808,"NYA","TBA",3,5,"TRUE",2
20200808,"ANA","TEX",0,2,"TRUE",2
20200809,"SFN","LAN",2,6,"TRUE",4
20200809,"CIN","MIL",3,9,"TRUE",6
20200809,"MIA","NYN",2,4,"TRUE",2
20200809,"ATL","PHI",5,2,"FALSE",-3
20200809,"ATL","PHI",8,0,"FALSE",-8
20200809,"DET","PIT",2,1,"FALSE",-1
20200809,"ARI","SDN",5,9,"TRUE",4
20200809,"BAL","WAS",6,2,"FALSE",-4
20200809,"TOR","BOS",3,5,"TRUE",2
20200809,"CLE","CHA",5,4,"FALSE",-1
20200809,"MIN","KCA",2,4,"TRUE",2
20200809,"HOU","OAK",2,7,"TRUE",5
20200809,"COL","SEA",3,5,"TRUE",2
20200809,"NYA","TBA",3,4,"TRUE",1
20200809,"ANA","TEX",3,7,"TRUE",4
20200810,"ARI","COL",12,8,"FALSE",-4
20200810,"SDN","LAN",2,1,"FALSE",-1
20200810,"MIN","MIL",4,2,"FALSE",-2
20200810,"WAS","NYN",16,4,"FALSE",-12
20200810,"ATL","PHI",8,13,"TRUE",5
20200810,"OAK","ANA",9,10,"TRUE",1
20200810,"TBA","BOS",8,7,"FALSE",-1
20200810,"CHA","DET",1,5,"TRUE",4
20200810,"SFN","HOU",4,6,"TRUE",2
20200810,"SEA","TEX",10,2,"FALSE",-8
20200811,"KCA","CIN",5,6,"TRUE",1
20200811,"ARI","COL",7,8,"TRUE",1
20200811,"SDN","LAN",6,2,"FALSE",-4
20200811,"MIN","MIL",4,6,"TRUE",2
20200811,"WAS","NYN",2,1,"FALSE",-1
20200811,"BAL","PHI",10,9,"FALSE",-1
20200811,"OAK","ANA",0,6,"TRUE",6
20200811,"TBA","BOS",8,2,"FALSE",-6
20200811,"CHN","CLE",7,1,"FALSE",-6
20200811,"CHA","DET",8,4,"FALSE",-4
20200811,"SFN","HOU",7,6,"FALSE",-1
20200811,"ATL","NYA",6,9,"TRUE",3
20200811,"SEA","TEX",2,4,"TRUE",2
20200811,"MIA","TOR",4,5,"TRUE",1
20200812,"KCA","CIN",5,4,"FALSE",-1
20200812,"ARI","COL",13,7,"FALSE",-6
20200812,"SDN","LAN",0,6,"TRUE",6
20200812,"MIN","MIL",12,2,"FALSE",-10
20200812,"WAS","NYN",6,11,"TRUE",5
20200812,"BAL","PHI",5,4,"FALSE",-1
20200812,"OAK","ANA",8,4,"FALSE",-4
20200812,"TBA","BOS",9,5,"FALSE",-4
20200812,"CHN","CLE",7,2,"FALSE",-5
20200812,"CHA","DET",7,5,"FALSE",-2
20200812,"SFN","HOU",1,5,"TRUE",4
20200812,"ATL","NYA",3,6,"TRUE",3
20200812,"SEA","TEX",4,7,"TRUE",3
20200812,"MIA","TOR",14,11,"FALSE",-3
20200813,"MIL","CHN",2,4,"TRUE",2
20200813,"PIT","CIN",9,6,"FALSE",-3
20200813,"SDN","LAN",2,11,"TRUE",9
20200813,"WAS","NYN",2,8,"TRUE",6
20200813,"BAL","PHI",11,4,"FALSE",-7
20200813,"TBA","BOS",17,8,"FALSE",-9
20200814,"SDN","ARI",1,5,"TRUE",4
20200814,"MIL","CHN",4,3,"FALSE",-1
20200814,"PIT","CIN",1,8,"TRUE",7
20200814,"TEX","COL",3,2,"FALSE",-1
20200814,"ATL","MIA",2,8,"TRUE",6
20200814,"NYN","PHI",5,6,"TRUE",1
20200814,"OAK","SFN",8,7,"FALSE",-1
20200814,"LAN","ANA",7,4,"FALSE",-3
20200814,"WAS","BAL",15,3,"FALSE",-12
20200814,"CLE","DET",10,5,"FALSE",-5
20200814,"SEA","HOU",1,11,"TRUE",10
20200814,"BOS","NYA",3,10,"TRUE",7
20200814,"TBA","TOR",4,12,"TRUE",8
20200815,"SDN","ARI",6,7,"TRUE",1
20200815,"MIL","CHN",6,5,"FALSE",-1
20200815,"TEX","COL",6,4,"FALSE",-2
20200815,"ATL","MIA",2,1,"FALSE",-1
20200815,"NYN","PHI",2,6,"TRUE",4
20200815,"OAK","SFN",7,6,"FALSE",-1
20200815,"LAN","ANA",6,5,"FALSE",-1
20200815,"WAS","BAL",3,7,"TRUE",4
20200815,"SLN","CHA",5,1,"FALSE",-4
20200815,"SLN","CHA",6,3,"FALSE",-3
20200815,"CLE","DET",3,1,"FALSE",-2
20200815,"SEA","HOU",1,2,"TRUE",1
20200815,"KCA","MIN",2,4,"TRUE",2
20200815,"KCA","MIN",4,2,"FALSE",-2
20200815,"BOS","NYA",5,11,"TRUE",6
20200815,"TBA","TOR",3,2,"FALSE",-1
20200816,"SDN","ARI",4,5,"TRUE",1
20200816,"MIL","CHN",6,5,"FALSE",-1
20200816,"TEX","COL",6,10,"TRUE",4
20200816,"ATL","MIA",4,0,"FALSE",-4
20200816,"NYN","PHI",2,6,"TRUE",4
20200816,"OAK","SFN",15,3,"FALSE",-12
20200816,"LAN","ANA",8,3,"FALSE",-5
20200816,"WAS","BAL",6,5,"FALSE",-1
20200816,"SLN","CHA",2,7,"TRUE",5
20200816,"CLE","DET",8,5,"FALSE",-3
20200816,"SEA","HOU",2,3,"TRUE",1
20200816,"KCA","MIN",2,4,"TRUE",2
20200816,"BOS","NYA",2,4,"TRUE",2
20200816,"TBA","TOR",7,5,"FALSE",-2
20200817,"OAK","ARI",3,4,"TRUE",1
20200817,"WAS","ATL",6,7,"TRUE",1
20200817,"SLN","CHN",3,1,"FALSE",-2
20200817,"SLN","CHN",4,5,"TRUE",1
20200817,"SEA","LAN",9,11,"TRUE",2
20200817,"NYN","MIA",11,4,"FALSE",-7
20200817,"SFN","ANA",6,7,"TRUE",1
20200817,"TOR","BAL",7,2,"FALSE",-5
20200817,"DET","CHA",2,7,"TRUE",5
20200817,"COL","HOU",1,2,"TRUE",1
20200817,"KCA","MIN",1,4,"TRUE",3
20200817,"BOS","NYA",3,6,"TRUE",3
20200817,"SDN","TEX",14,4,"FALSE",-10
20200818,"OAK","ARI",1,10,"TRUE",9
20200818,"WAS","ATL",8,5,"FALSE",-3
20200818,"SLN","CHN",3,6,"TRUE",3
20200818,"SEA","LAN",1,2,"TRUE",1
20200818,"NYN","MIA",8,3,"FALSE",-5
20200818,"CLE","PIT",6,3,"FALSE",-3
20200818,"SFN","ANA",8,2,"FALSE",-6
20200818,"TOR","BAL",8,7,"FALSE",-1
20200818,"PHI","BOS",13,6,"FALSE",-7
20200818,"DET","CHA",4,10,"TRUE",6
20200818,"COL","HOU",1,2,"TRUE",1
20200818,"MIL","MIN",3,4,"TRUE",1
20200818,"TBA","NYA",6,3,"FALSE",-3
20200818,"SDN","TEX",6,4,"FALSE",-2
20200819,"SLN","CHN",9,3,"FALSE",-6
20200819,"SLN","CHN",2,4,"TRUE",2
20200819,"HOU","COL",13,6,"FALSE",-7
20200819,"NYN","MIA",5,3,"FALSE",-2
20200819,"CLE","PIT",6,1,"FALSE",-5
20200819,"TEX","SDN",3,6,"TRUE",3
20200819,"ANA","SFN",2,7,"TRUE",5
20200819,"TOR","BAL",5,2,"FALSE",-3
20200819,"PHI","BOS",3,6,"TRUE",3
20200819,"DET","CHA",3,5,"TRUE",2
20200819,"CIN","KCA",0,4,"TRUE",4
20200819,"CIN","KCA",5,0,"FALSE",-5
20200819,"MIL","MIN",9,3,"FALSE",-6
20200819,"TBA","NYA",4,2,"FALSE",-2
20200819,"ARI","OAK",1,4,"TRUE",3
20200819,"LAN","SEA",4,6,"TRUE",2
20200820,"HOU","COL",10,8,"FALSE",-2
20200820,"CLE","PIT",2,0,"FALSE",-2
20200820,"TEX","SDN",7,8,"TRUE",1
20200820,"ANA","SFN",5,10,"TRUE",5
20200820,"CIN","SLN",4,5,"TRUE",1
20200820,"BOS","BAL",7,1,"FALSE",-6
20200820,"DET","CHA",0,9,"TRUE",9
20200820,"MIL","MIN",1,7,"TRUE",6
20200820,"TBA","NYA",10,5,"FALSE",-5
20200820,"ARI","OAK",1,5,"TRUE",4
20200820,"LAN","SEA",6,1,"FALSE",-5
20200820,"PHI","TOR",2,3,"TRUE",1
20200820,"PHI","TOR",8,9,"TRUE",1
20200821,"PHI","ATL",2,11,"TRUE",9
20200821,"CHA","CHN",10,1,"FALSE",-9
20200821,"COL","LAN",1,5,"TRUE",4
20200821,"MIL","PIT",2,7,"TRUE",5
20200821,"HOU","SDN",3,4,"TRUE",1
20200821,"ARI","SFN",2,6,"TRUE",4
20200821,"CIN","SLN",4,2,"FALSE",-2
20200821,"MIA","WAS",3,2,"FALSE",-1
20200821,"BOS","BAL",8,5,"FALSE",-3
20200821,"DET","CLE",10,5,"FALSE",-5
20200821,"MIN","KCA",2,7,"TRUE",5
20200821,"ANA","OAK",3,5,"TRUE",2
20200821,"TEX","SEA",4,7,"TRUE",3
20200821,"TOR","TBA",6,5,"FALSE",-1
20200822,"PHI","ATL",5,6,"TRUE",1
20200822,"CHA","CHN",7,4,"FALSE",-3
20200822,"COL","LAN",3,4,"TRUE",1
20200822,"MIL","PIT",5,12,"TRUE",7
20200822,"HOU","SDN",2,13,"TRUE",11
20200822,"ARI","SFN",1,5,"TRUE",4
20200822,"CIN","SLN",0,3,"TRUE",3
20200822,"MIA","WAS",4,5,"TRUE",1
20200822,"MIA","WAS",5,3,"FALSE",-2
20200822,"BOS","BAL",4,5,"TRUE",1
20200822,"DET","CLE",1,6,"TRUE",5
20200822,"MIN","KCA",7,2,"FALSE",-5
20200822,"ANA","OAK",4,3,"FALSE",-1
20200822,"TEX","SEA",1,10,"TRUE",9
20200822,"TOR","TBA",1,2,"TRUE",1
20200823,"PHI","ATL",5,4,"FALSE",-1
20200823,"CHA","CHN",1,2,"TRUE",1
20200823,"COL","LAN",3,11,"TRUE",8
20200823,"MIL","PIT",4,5,"TRUE",1
20200823,"HOU","SDN",3,5,"TRUE",2
20200823,"ARI","SFN",1,6,"TRUE",5
20200823,"CIN","SLN",2,6,"TRUE",4
20200823,"MIA","WAS",3,9,"TRUE",6
20200823,"BOS","BAL",4,5,"TRUE",1
20200823,"DET","CLE",7,4,"FALSE",-3
20200823,"MIN","KCA",5,4,"FALSE",-1
20200823,"ANA","OAK",4,5,"TRUE",1
20200823,"TEX","SEA",1,4,"TRUE",3
20200823,"TOR","TBA",4,5,"TRUE",1
20200824,"COL","ARI",3,2,"FALSE",-1
20200824,"CIN","MIL",2,4,"TRUE",2
20200824,"KCA","SLN",3,9,"TRUE",6
20200824,"MIA","WAS",11,8,"FALSE",-3
20200824,"MIN","CLE",3,2,"FALSE",-1
20200824,"CHN","DET",9,3,"FALSE",-6
20200824,"ANA","HOU",4,11,"TRUE",7
20200824,"TOR","TBA",6,4,"FALSE",-2
20200824,"OAK","TEX",2,3,"TRUE",1
20200825,"COL","ARI",5,4,"FALSE",-1
20200825,"CIN","MIL",2,3,"TRUE",1
20200825,"MIA","NYN",4,0,"FALSE",-4
20200825,"MIA","NYN",3,0,"FALSE",-3
20200825,"SEA","SDN",8,3,"FALSE",-5
20200825,"LAN","SFN",8,10,"TRUE",2
20200825,"KCA","SLN",5,4,"FALSE",-1
20200825,"PHI","WAS",8,3,"FALSE",-5
20200825,"PIT","CHA",0,4,"TRUE",4
20200825,"MIN","CLE",2,4,"TRUE",2
20200825,"CHN","DET",1,7,"TRUE",6
20200825,"ANA","HOU",3,6,"TRUE",3
20200825,"ANA","HOU",12,5,"FALSE",-7
20200825,"BAL","TBA",2,4,"TRUE",2
20200825,"OAK","TEX",10,3,"FALSE",-7
20200825,"BOS","TOR",9,7,"FALSE",-2
20200826,"COL","ARI",8,7,"FALSE",-1
20200826,"NYA","ATL",1,5,"TRUE",4
20200826,"NYA","ATL",1,2,"TRUE",1
20200826,"MIA","NYN",4,5,"TRUE",1
20200826,"KCA","SLN",5,6,"TRUE",1
20200826,"PHI","WAS",3,2,"FALSE",-1
20200826,"PIT","CHA",3,10,"TRUE",7
20200826,"MIN","CLE",3,6,"TRUE",3
20200826,"CHN","DET",6,7,"TRUE",1
20200826,"BAL","TBA",3,4,"TRUE",1
20200826,"OAK","TEX",3,1,"FALSE",-2
20200826,"BOS","TOR",1,9,"TRUE",8
20200827,"CIN","MIL",6,1,"FALSE",-5
20200827,"CIN","MIL",6,0,"FALSE",-6
20200827,"SEA","SDN",7,10,"TRUE",3
20200827,"SEA","SDN",8,3,"FALSE",-5
20200827,"LAN","SFN",7,0,"FALSE",-7
20200827,"LAN","SFN",2,0,"FALSE",-2
20200827,"PIT","SLN",4,3,"FALSE",-1
20200827,"PIT","SLN",2,0,"FALSE",-2
20200828,"SFN","ARI",4,7,"TRUE",3
20200828,"CHN","CIN",5,6,"TRUE",1
20200828,"SDN","COL",10,4,"FALSE",-6
20200828,"TBA","MIA",2,0,"FALSE",-2
20200828,"PIT","MIL",1,9,"TRUE",8
20200828,"ATL","PHI",4,7,"TRUE",3
20200828,"CLE","SLN",14,2,"FALSE",-12
20200828,"SEA","ANA",2,3,"TRUE",1
20200828,"WAS","BOS",10,2,"FALSE",-8
20200828,"KCA","CHA",5,6,"TRUE",1
20200828,"NYN","NYA",6,4,"FALSE",-2
20200828,"NYN","NYA",4,3,"FALSE",-1
20200828,"LAN","TEX",2,6,"TRUE",4
20200828,"BAL","TOR",4,5,"TRUE",1
20200829,"SFN","ARI",5,2,"FALSE",-3
20200829,"CHN","CIN",3,0,"FALSE",-3
20200829,"CHN","CIN",5,6,"TRUE",1
20200829,"SDN","COL",3,4,"TRUE",1
20200829,"TBA","MIA",4,0,"FALSE",-4
20200829,"PIT","MIL",6,7,"TRUE",1
20200829,"ATL","PHI",1,4,"TRUE",3
20200829,"CLE","SLN",2,1,"FALSE",-1
20200829,"SEA","ANA",3,16,"TRUE",13
20200829,"WAS","BOS",3,5,"TRUE",2
20200829,"KCA","CHA",9,6,"FALSE",-3
20200829,"MIN","DET",2,8,"TRUE",6
20200829,"MIN","DET",2,4,"TRUE",2
20200829,"OAK","HOU",2,4,"TRUE",2
20200829,"OAK","HOU",3,6,"TRUE",3
20200829,"NYN","NYA",1,2,"TRUE",1
20200829,"LAN","TEX",7,4,"FALSE",-3
20200829,"BAL","TOR",0,5,"TRUE",5
20200830,"SFN","ARI",4,1,"FALSE",-3
20200830,"CHN","CIN",10,1,"FALSE",-9
20200830,"SDN","COL",13,2,"FALSE",-11
20200830,"TBA","MIA",12,7,"FALSE",-5
20200830,"PIT","MIL",5,1,"FALSE",-4
20200830,"ATL","PHI",12,10,"FALSE",-2
20200830,"CLE","SLN",2,7,"TRUE",5
20200830,"SEA","ANA",2,1,"FALSE",-1
20200830,"WAS","BOS",5,9,"TRUE",4
20200830,"KCA","CHA",2,5,"TRUE",3
20200830,"MIN","DET",2,3,"TRUE",1
20200830,"NYN","NYA",7,8,"TRUE",1
20200830,"NYN","NYA",2,5,"TRUE",3
20200830,"LAN","TEX",7,2,"FALSE",-5
20200830,"BAL","TOR",5,6,"TRUE",1
20200831,"SLN","CIN",7,5,"FALSE",-2
20200831,"SDN","COL",6,0,"FALSE",-6
20200831,"PIT","MIL",5,6,"TRUE",1
20200831,"MIA","NYN",5,3,"FALSE",-2
20200831,"WAS","PHI",6,8,"TRUE",2
20200831,"SEA","ANA",2,1,"FALSE",-1
20200831,"ATL","BOS",6,3,"FALSE",-3
20200831,"CLE","KCA",1,2,"TRUE",1
20200831,"CHA","MIN",8,5,"FALSE",-3
20200831,"TBA","NYA",5,3,"FALSE",-2
20200831,"BAL","TOR",4,3,"FALSE",-1
20200901,"SLN","CIN",16,2,"FALSE",-14
20200901,"SFN","COL",23,5,"FALSE",-18
20200901,"ARI","LAN",3,6,"TRUE",3
20200901,"TOR","MIA",2,3,"TRUE",1
20200901,"DET","MIL",12,1,"FALSE",-11
20200901,"WAS","PHI",0,6,"TRUE",6
20200901,"CHN","PIT",8,7,"FALSE",-1
20200901,"NYN","BAL",5,9,"TRUE",4
20200901,"ATL","BOS",10,3,"FALSE",-7
20200901,"TEX","HOU",6,5,"FALSE",-1
20200901,"CLE","KCA",10,1,"FALSE",-9
20200901,"CHA","MIN",2,3,"TRUE",1
20200901,"TBA","NYA",3,5,"TRUE",2
20200902,"SLN","CIN",3,4,"TRUE",1
20200902,"SFN","COL",6,9,"TRUE",3
20200902,"ARI","LAN",2,3,"TRUE",1
20200902,"TOR","MIA",2,1,"FALSE",-1
20200902,"DET","MIL",5,8,"TRUE",3
20200902,"WAS","PHI",0,3,"TRUE",3
20200902,"CHN","PIT",8,2,"FALSE",-6
20200902,"SDN","ANA",11,4,"FALSE",-7
20200902,"NYN","BAL",9,4,"FALSE",-5
20200902,"ATL","BOS",7,5,"FALSE",-2
20200902,"TEX","HOU",1,2,"TRUE",1
20200902,"CLE","KCA",5,0,"FALSE",-5
20200902,"CHA","MIN",1,8,"TRUE",7
20200902,"TBA","NYA",5,2,"FALSE",-3
20200903,"ARI","LAN",1,5,"TRUE",4
20200903,"NYA","NYN",7,9,"TRUE",2
20200903,"WAS","PHI",5,6,"TRUE",1
20200903,"CHN","PIT",2,6,"TRUE",4
20200903,"SDN","ANA",0,2,"TRUE",2
20200903,"TOR","BOS",6,2,"FALSE",-4
20200903,"TEX","HOU",4,8,"TRUE",4
20200903,"CHA","KCA",11,6,"FALSE",-5
20200904,"WAS","ATL",1,7,"TRUE",6
20200904,"WAS","ATL",10,9,"FALSE",-1
20200904,"SLN","CHN",1,4,"TRUE",3
20200904,"COL","LAN",6,10,"TRUE",4
20200904,"PHI","NYN",5,3,"FALSE",-2
20200904,"CIN","PIT",4,2,"FALSE",-2
20200904,"CIN","PIT",3,4,"TRUE",1
20200904,"ARI","SFN",6,5,"FALSE",-1
20200904,"HOU","ANA",5,6,"TRUE",1
20200904,"NYA","BAL",6,5,"FALSE",-1
20200904,"NYA","BAL",3,6,"TRUE",3
20200904,"TOR","BOS",8,7,"FALSE",-1
20200904,"TOR","BOS",2,3,"TRUE",1
20200904,"MIL","CLE",7,1,"FALSE",-6
20200904,"CHA","KCA",7,4,"FALSE",-3
20200904,"DET","MIN",0,2,"TRUE",2
20200904,"DET","MIN",2,3,"TRUE",1
20200904,"SDN","OAK",7,0,"FALSE",-7
20200904,"TEX","SEA",3,6,"TRUE",3
20200904,"MIA","TBA",4,5,"TRUE",1
20200905,"WAS","ATL",10,4,"FALSE",-6
20200905,"SLN","CHN",4,2,"FALSE",-2
20200905,"SLN","CHN",5,1,"FALSE",-4
20200905,"COL","LAN",5,2,"FALSE",-3
20200905,"PHI","NYN",1,5,"TRUE",4
20200905,"CIN","PIT",6,2,"FALSE",-4
20200905,"ARI","SFN",3,4,"TRUE",1
20200905,"HOU","ANA",9,10,"TRUE",1
20200905,"HOU","ANA",6,7,"TRUE",1
20200905,"NYA","BAL",1,6,"TRUE",5
20200905,"TOR","BOS",8,9,"TRUE",1
20200905,"MIL","CLE",3,4,"TRUE",1
20200905,"CHA","KCA",5,3,"FALSE",-2
20200905,"DET","MIN",3,4,"TRUE",1
20200905,"SDN","OAK",4,8,"TRUE",4
20200905,"TEX","SEA",3,5,"TRUE",2
20200905,"MIA","TBA",7,3,"FALSE",-4
20200906,"WAS","ATL",3,10,"TRUE",7
20200906,"SLN","CHN",7,3,"FALSE",-4
20200906,"COL","LAN",7,6,"FALSE",-1
20200906,"PHI","NYN",1,14,"TRUE",13
20200906,"CIN","PIT",2,3,"TRUE",1
20200906,"ARI","SFN",2,4,"TRUE",2
20200906,"HOU","ANA",5,9,"TRUE",4
20200906,"NYA","BAL",1,5,"TRUE",4
20200906,"TOR","BOS",10,8,"FALSE",-2
20200906,"MIL","CLE",1,4,"TRUE",3
20200906,"CHA","KCA",8,2,"FALSE",-6
20200906,"DET","MIN",10,8,"FALSE",-2
20200906,"SDN","OAK",5,3,"FALSE",-2
20200906,"TEX","SEA",3,4,"TRUE",1
20200906,"MIA","TBA",4,5,"TRUE",1
20200907,"MIA","ATL",5,4,"FALSE",-1
20200907,"SLN","CHN",1,5,"TRUE",4
20200907,"PHI","NYN",9,8,"FALSE",-1
20200907,"COL","SDN",0,1,"TRUE",1
20200907,"ARI","SFN",2,4,"TRUE",2
20200907,"TBA","WAS",1,6,"TRUE",5
20200907,"KCA","CLE",2,5,"TRUE",3
20200907,"DET","MIN",2,6,"TRUE",4
20200907,"HOU","OAK",0,6,"TRUE",6
20200907,"TEX","SEA",4,8,"TRUE",4
20200907,"NYA","TOR",7,12,"TRUE",5
20200908,"LAN","ARI",10,9,"FALSE",-1
20200908,"MIA","ATL",8,0,"FALSE",-8
20200908,"CIN","CHN",0,3,"TRUE",3
20200908,"BAL","NYN",11,2,"FALSE",-9
20200908,"BOS","PHI",5,6,"TRUE",1
20200908,"BOS","PHI",5,2,"FALSE",-3
20200908,"CHA","PIT",4,5,"TRUE",1
20200908,"COL","SDN",5,14,"TRUE",9
20200908,"SEA","SFN",5,6,"TRUE",1
20200908,"MIN","SLN",7,3,"FALSE",-4
20200908,"MIN","SLN",4,6,"TRUE",2
20200908,"TBA","WAS",3,5,"TRUE",2
20200908,"KCA","CLE",8,6,"FALSE",-2
20200908,"MIL","DET",3,8,"TRUE",5
20200908,"HOU","OAK",2,4,"TRUE",2
20200908,"HOU","OAK",5,4,"FALSE",-1
20200908,"ANA","TEX",1,7,"TRUE",6
20200908,"NYA","TOR",1,2,"TRUE",1
20200909,"LAN","ARI",6,4,"FALSE",-2
20200909,"MIA","ATL",9,29,"TRUE",20
20200909,"CIN","CHN",3,0,"FALSE",-3
20200909,"BAL","NYN",6,7,"TRUE",1
20200909,"CHA","PIT",8,1,"FALSE",-7
20200909,"COL","SDN",3,5,"TRUE",2
20200909,"SEA","SFN",1,10,"TRUE",9
20200909,"KCA","CLE",3,0,"FALSE",-3
20200909,"MIL","DET",19,0,"FALSE",-19
20200909,"HOU","OAK",2,3,"TRUE",1
20200909,"ANA","TEX",3,7,"TRUE",4
20200909,"NYA","TOR",7,2,"FALSE",-5
20200910,"LAN","ARI",2,5,"TRUE",3
20200910,"CIN","CHN",5,8,"TRUE",3
20200910,"PHI","MIA",6,7,"TRUE",1
20200910,"SFN","SDN",1,6,"TRUE",5
20200910,"DET","SLN",2,12,"TRUE",10
20200910,"DET","SLN",6,3,"FALSE",-3
20200910,"ATL","WAS",7,6,"FALSE",-1
20200910,"KCA","CLE",11,1,"FALSE",-10
20200910,"HOU","OAK",1,3,"TRUE",2
20200910,"BOS","TBA",4,3,"FALSE",-1
20200910,"ANA","TEX",6,2,"FALSE",-4
20200911,"SEA","ARI",3,4,"TRUE",1
20200911,"ANA","COL",4,8,"TRUE",4
20200911,"PHI","MIA",11,0,"FALSE",-11
20200911,"PHI","MIA",3,5,"TRUE",2
20200911,"CHN","MIL",0,1,"TRUE",1
20200911,"CIN","SLN",3,1,"FALSE",-2
20200911,"ATL","WAS",7,8,"TRUE",1
20200911,"DET","CHA",3,4,"TRUE",1
20200911,"PIT","KCA",3,4,"TRUE",1
20200911,"CLE","MIN",1,3,"TRUE",2
20200911,"BAL","NYA",0,6,"TRUE",6
20200911,"BAL","NYA",1,10,"TRUE",9
20200911,"BOS","TBA",1,11,"TRUE",10
20200911,"OAK","TEX",10,6,"FALSE",-4
20200911,"NYN","TOR",18,1,"FALSE",-17
20200912,"SEA","ARI",7,3,"FALSE",-4
20200912,"ANA","COL",5,2,"FALSE",-3
20200912,"HOU","LAN",7,5,"FALSE",-2
20200912,"PHI","MIA",12,6,"FALSE",-6
20200912,"CHN","MIL",4,2,"FALSE",-2
20200912,"CIN","SLN",1,7,"TRUE",6
20200912,"ATL","WAS",2,1,"FALSE",-1
20200912,"DET","CHA",0,14,"TRUE",14
20200912,"PIT","KCA",4,7,"TRUE",3
20200912,"CLE","MIN",4,8,"TRUE",4
20200912,"BAL","NYA",1,2,"TRUE",1
20200912,"BOS","TBA",4,5,"TRUE",1
20200912,"OAK","TEX",2,5,"TRUE",3
20200912,"OAK","TEX",10,1,"FALSE",-9
20200912,"NYN","TOR",2,3,"TRUE",1
20200913,"SEA","ARI",7,3,"FALSE",-4
20200913,"ANA","COL",5,3,"FALSE",-2
20200913,"HOU","LAN",1,8,"TRUE",7
20200913,"PHI","MIA",1,2,"TRUE",1
20200913,"PHI","MIA",1,8,"TRUE",7
20200913,"CHN","MIL",12,0,"FALSE",-12
20200913,"SFN","SDN",0,6,"TRUE",6
20200913,"SFN","SDN",1,3,"TRUE",2
20200913,"CIN","SLN",10,5,"FALSE",-5
20200913,"ATL","WAS",8,4,"FALSE",-4
20200913,"DET","CHA",2,5,"TRUE",3
20200913,"PIT","KCA",0,11,"TRUE",11
20200913,"CLE","MIN",5,7,"TRUE",2
20200913,"BAL","NYA",1,3,"TRUE",2
20200913,"BOS","TBA",6,3,"FALSE",-3
20200913,"OAK","TEX",3,6,"TRUE",3
20200913,"NYN","TOR",3,7,"TRUE",4
20200914,"PIT","CIN",1,3,"TRUE",2
20200914,"PIT","CIN",4,9,"TRUE",5
20200914,"PHI","MIA",2,6,"TRUE",4
20200914,"SLN","MIL",1,2,"TRUE",1
20200914,"SLN","MIL",3,2,"FALSE",-1
20200914,"LAN","SDN",2,7,"TRUE",5
20200914,"ATL","BAL",1,14,"TRUE",13
20200914,"MIN","CHA",1,3,"TRUE",2
20200914,"OAK","SEA",5,6,"TRUE",1
20200914,"OAK","SEA",9,0,"FALSE",-9
20200915,"CLE","CHN",5,6,"TRUE",1
20200915,"PIT","CIN",1,4,"TRUE",3
20200915,"OAK","COL",1,3,"TRUE",2
20200915,"BOS","MIA",2,0,"FALSE",-2
20200915,"SLN","MIL",3,18,"TRUE",15
20200915,"NYN","PHI",1,4,"TRUE",3
20200915,"LAN","SDN",3,1,"FALSE",-2
20200915,"ARI","ANA",9,8,"FALSE",-1
20200915,"ATL","BAL",5,1,"FALSE",-4
20200915,"MIN","CHA",2,6,"TRUE",4
20200915,"KCA","DET",0,6,"TRUE",6
20200915,"TEX","HOU",1,4,"TRUE",3
20200915,"TOR","NYA",6,20,"TRUE",14
20200915,"WAS","TBA",1,6,"TRUE",5
20200916,"CLE","CHN",2,3,"TRUE",1
20200916,"PIT","CIN",0,1,"TRUE",1
20200916,"OAK","COL",3,1,"FALSE",-2
20200916,"BOS","MIA",4,8,"TRUE",4
20200916,"SLN","MIL",4,2,"FALSE",-2
20200916,"SLN","MIL",0,6,"TRUE",6
20200916,"NYN","PHI",5,4,"FALSE",-1
20200916,"LAN","SDN",7,5,"FALSE",-2
20200916,"SEA","SFN",3,9,"TRUE",6
20200916,"ARI","ANA",9,6,"FALSE",-3
20200916,"ATL","BAL",1,5,"TRUE",4
20200916,"MIN","CHA",5,1,"FALSE",-4
20200916,"KCA","DET",4,0,"FALSE",-4
20200916,"TEX","HOU",1,0,"FALSE",-1
20200916,"TOR","NYA",2,13,"TRUE",11
20200916,"WAS","TBA",4,2,"FALSE",-2
20200917,"LAN","COL",9,3,"FALSE",-6
20200917,"BOS","MIA",5,3,"FALSE",-2
20200917,"NYN","PHI",10,6,"FALSE",-4
20200917,"SLN","PIT",1,5,"TRUE",4
20200917,"SEA","SFN",4,6,"TRUE",2
20200917,"ARI","ANA",3,7,"TRUE",4
20200917,"TBA","BAL",3,1,"FALSE",-2
20200917,"TBA","BAL",10,6,"FALSE",-4
20200917,"MIN","CHA",3,4,"TRUE",1
20200917,"CLE","DET",10,3,"FALSE",-7
20200917,"TEX","HOU",1,2,"TRUE",1
20200917,"TOR","NYA",7,10,"TRUE",3
20200918,"MIN","CHN",0,1,"TRUE",1
20200918,"CHA","CIN",1,7,"TRUE",6
20200918,"LAN","COL",15,6,"FALSE",-9
20200918,"WAS","MIA",5,0,"FALSE",-5
20200918,"WAS","MIA",3,14,"TRUE",11
20200918,"KCA","MIL",5,9,"TRUE",4
20200918,"ATL","NYN",15,2,"FALSE",-13
20200918,"TOR","PHI",0,7,"TRUE",7
20200918,"TOR","PHI",7,8,"TRUE",1
20200918,"SLN","PIT",6,5,"FALSE",-1
20200918,"SLN","PIT",7,2,"FALSE",-5
20200918,"SEA","SDN",1,6,"TRUE",5
20200918,"TEX","ANA",2,6,"TRUE",4
20200918,"TBA","BAL",2,1,"FALSE",-1
20200918,"NYA","BOS",6,5,"FALSE",-1
20200918,"CLE","DET",1,0,"FALSE",-1
20200918,"ARI","HOU",6,3,"FALSE",-3
20200918,"SFN","OAK",0,6,"TRUE",6
20200919,"MIN","CHN",8,1,"FALSE",-7
20200919,"CHA","CIN",5,0,"FALSE",-5
20200919,"LAN","COL",6,1,"FALSE",-5
20200919,"WAS","MIA",3,7,"TRUE",4
20200919,"KCA","MIL",0,5,"TRUE",5
20200919,"ATL","NYN",2,7,"TRUE",5
20200919,"TOR","PHI",1,3,"TRUE",2
20200919,"SLN","PIT",5,4,"FALSE",-1
20200919,"SEA","SDN",4,1,"FALSE",-3
20200919,"TEX","ANA",3,4,"TRUE",1
20200919,"TBA","BAL",3,1,"FALSE",-2
20200919,"NYA","BOS",8,0,"FALSE",-8
20200919,"CLE","DET",2,5,"TRUE",3
20200919,"ARI","HOU",2,3,"TRUE",1
20200919,"SFN","OAK",0,6,"TRUE",6
20200920,"MIN","CHN",4,0,"FALSE",-4
20200920,"CHA","CIN",3,7,"TRUE",4
20200920,"LAN","COL",3,6,"TRUE",3
20200920,"WAS","MIA",1,2,"TRUE",1
20200920,"WAS","MIA",15,0,"FALSE",-15
20200920,"KCA","MIL",3,5,"TRUE",2
20200920,"ATL","NYN",7,0,"FALSE",-7
20200920,"TOR","PHI",6,3,"FALSE",-3
20200920,"SLN","PIT",2,1,"FALSE",-1
20200920,"SEA","SDN",4,7,"TRUE",3
20200920,"TEX","ANA",7,2,"FALSE",-5
20200920,"TBA","BAL",1,2,"TRUE",1
20200920,"NYA","BOS",2,10,"TRUE",8
20200920,"CLE","DET",7,4,"FALSE",-3
20200920,"ARI","HOU",2,3,"TRUE",1
20200920,"SFN","OAK",14,2,"FALSE",-12
20200921,"MIA","ATL",4,5,"TRUE",1
20200921,"MIL","CIN",3,6,"TRUE",3
20200921,"TBA","NYN",2,1,"FALSE",-1
20200921,"CHN","PIT",5,0,"FALSE",-5
20200921,"COL","SFN",7,2,"FALSE",-5
20200921,"PHI","WAS",1,5,"TRUE",4
20200921,"TEX","ANA",5,8,"TRUE",3
20200921,"CHA","CLE",4,7,"TRUE",3
20200921,"SLN","KCA",1,4,"TRUE",3
20200921,"HOU","SEA",1,6,"TRUE",5
20200921,"NYA","TOR",5,11,"TRUE",6
20200922,"TEX","ARI",0,7,"TRUE",7
20200922,"MIA","ATL",1,11,"TRUE",10
20200922,"MIL","CIN",3,2,"FALSE",-1
20200922,"OAK","LAN",2,7,"TRUE",5
20200922,"TBA","NYN",2,5,"TRUE",3
20200922,"CHN","PIT",2,3,"TRUE",1
20200922,"ANA","SDN",4,2,"FALSE",-2
20200922,"COL","SFN",2,5,"TRUE",3
20200922,"PHI","WAS",1,5,"TRUE",4
20200922,"PHI","WAS",7,8,"TRUE",1
20200922,"BAL","BOS",3,8,"TRUE",5
20200922,"CHA","CLE",3,5,"TRUE",2
20200922,"SLN","KCA",5,0,"FALSE",-5
20200922,"DET","MIN",4,5,"TRUE",1
20200922,"HOU","SEA",6,1,"FALSE",-5
20200922,"NYA","TOR",12,1,"FALSE",-11
20200923,"TEX","ARI",3,7,"TRUE",4
20200923,"MIA","ATL",4,9,"TRUE",5
20200923,"MIL","CIN",1,6,"TRUE",5
20200923,"OAK","LAN",6,4,"FALSE",-2
20200923,"TBA","NYN",8,5,"FALSE",-3
20200923,"CHN","PIT",1,2,"TRUE",1
20200923,"ANA","SDN",5,2,"FALSE",-3
20200923,"COL","SFN",2,7,"TRUE",5
20200923,"PHI","WAS",12,3,"FALSE",-9
20200923,"BAL","BOS",1,9,"TRUE",8
20200923,"CHA","CLE",2,3,"TRUE",1
20200923,"SLN","KCA",3,12,"TRUE",9
20200923,"DET","MIN",6,7,"TRUE",1
20200923,"HOU","SEA",2,3,"TRUE",1
20200923,"NYA","TOR",1,14,"TRUE",13
20200924,"MIA","ATL",4,2,"FALSE",-2
20200924,"OAK","LAN",1,5,"TRUE",4
20200924,"CHN","PIT",0,7,"TRUE",7
20200924,"COL","SFN",5,4,"FALSE",-1
20200924,"MIL","SLN",2,4,"TRUE",2
20200924,"NYN","WAS",3,2,"FALSE",-1
20200924,"BAL","BOS",13,1,"FALSE",-12
20200924,"CHA","CLE",4,5,"TRUE",1
20200924,"DET","KCA",7,8,"TRUE",1
20200924,"HOU","TEX",12,4,"FALSE",-8
20200924,"NYA","TOR",1,4,"TRUE",3
20200925,"COL","ARI",0,4,"TRUE",4
20200925,"COL","ARI",5,11,"TRUE",6
20200925,"BOS","ATL",7,8,"TRUE",1
20200925,"ANA","LAN",5,9,"TRUE",4
20200925,"SDN","SFN",4,5,"TRUE",1
20200925,"SDN","SFN",6,5,"FALSE",-1
20200925,"MIL","SLN",3,0,"FALSE",-3
20200925,"MIL","SLN",1,9,"TRUE",8
20200925,"CHN","CHA",10,0,"FALSE",-10
20200925,"PIT","CLE",3,4,"TRUE",1
20200925,"DET","KCA",2,3,"TRUE",1
20200925,"CIN","MIN",7,2,"FALSE",-5
20200925,"MIA","NYA",4,3,"FALSE",-1
20200925,"SEA","OAK",1,3,"TRUE",2
20200925,"PHI","TBA",4,6,"TRUE",2
20200925,"HOU","TEX",4,5,"TRUE",1
20200925,"BAL","TOR",5,10,"TRUE",5
20200926,"COL","ARI",10,3,"FALSE",-7
20200926,"BOS","ATL",8,2,"FALSE",-6
20200926,"ANA","LAN",6,7,"TRUE",1
20200926,"SDN","SFN",6,2,"FALSE",-4
20200926,"MIL","SLN",3,0,"FALSE",-3
20200926,"NYN","WAS",3,4,"TRUE",1
20200926,"NYN","WAS",3,5,"TRUE",2
20200926,"CHN","CHA",5,9,"TRUE",4
20200926,"PIT","CLE",8,0,"FALSE",-8
20200926,"DET","KCA",4,3,"FALSE",-1
20200926,"CIN","MIN",3,7,"TRUE",4
20200926,"MIA","NYA",4,11,"TRUE",7
20200926,"SEA","OAK",5,1,"FALSE",-4
20200926,"SEA","OAK",12,3,"FALSE",-9
20200926,"PHI","TBA",3,4,"TRUE",1
20200926,"HOU","TEX",1,6,"TRUE",5
20200926,"BAL","TOR",2,5,"TRUE",3
20200927,"COL","ARI",3,11,"TRUE",8
20200927,"BOS","ATL",9,1,"FALSE",-8
20200927,"ANA","LAN",0,5,"TRUE",5
20200927,"SDN","SFN",5,4,"FALSE",-1
20200927,"MIL","SLN",2,5,"TRUE",3
20200927,"NYN","WAS",5,15,"TRUE",10
20200927,"CHN","CHA",10,8,"FALSE",-2
20200927,"PIT","CLE",6,8,"TRUE",2
20200927,"DET","KCA",1,3,"TRUE",2
20200927,"CIN","MIN",5,3,"FALSE",-2
20200927,"MIA","NYA",5,0,"FALSE",-5
20200927,"SEA","OAK",2,6,"TRUE",4
20200927,"PHI","TBA",0,5,"TRUE",5
20200927,"HOU","TEX",4,8,"TRUE",4
20200927,"BAL","TOR",7,5,"FALSE",-2
